1F 1F 2F 3W 2F 1F 0F 4F
1F 1W 2F 3W 2F 1F 0F 4W
1W 1W 2F 3F 2F 1F 0F 4F
1F 1F 2F 3W 2F 1F 0F 3W
1F 1W 2W 3F 2F 1F 0F 3F
1W 1W 2W 3W 2F 1F 0F 2W
1F 1F 1F 1F 1F 0F 0F 6W
